5  5  24 5  5  5  5  5  5  24 5  5  5  5  5  5  5  5  5  5  5  5  5  5  5  5  5  5  5  5  5  5  5  5  24 24 24 24 24 24 24 24 24 24 24 24 24 24 24 24 24 24 24 24 24 24 24 24 24 24 24 24 24 24 24 24 24 24 24 24 24 24 24 24 24 24 24 24 24 24 
5  5  24 5  5  5  5  5  5  24 5  5  5  5  5  5  5  5  5  5  5  5  5  5  5  5  5  5  5  5  5  5  5  5  24 5  5  5  5  5  5  5  5  5  5  5  5  5  5  5  5  5  5  5  5  5  5  5  5  5  5  5  5  5  5  5  5  5  5  5  5  5  5  5  5  5  5  5  5  5 
5  5  24 5  5  5  5  5  5  24 5  5  5  5  5  5  5  5  5  5  5  5  5  5  5  5  5  5  5  5  5  5  5  25 24 5  5  5  5  5  5  5  5  5  5  5  5  5  5  5  5  5  5  5  5  5  5  5  5  5  5  5  5  5  5  5  5  5  5  5  5  5  5  5  5  5  5  5  5  5 
5  5  24 25 25 25 25 5  5  24 5  5  5  5  5  5  5  5  25 25 25 25 5  5  5  5  5  5  5  5  5  5  5  5  24 5  5  5  5  5  5  5  5  5  5  5  5  5  5  5  5  5  5  5  5  5  5  5  5  5  5  5  5  5  5  5  5  5  5  5  5  5  5  5  5  5  5  5  5  5 
5  5  5  5  5  5  5  5  5  24 25 25 25 25 25 5  5  5  5  24 24 24 25 5  5  5  5  5  5  5  5  5  5  5  5  5  5  5  5  5  5  5  5  5  5  5  5  5  5  5  5  5  5  5  5  5  5  5  5  5  5  5  5  5  5  5  5  5  5  5  5  5  5  5  5  5  5  5  5  5 
5  5  5  5  5  5  5  5  5  24 26 26 26 24 26 25 5  5  5  5  5  5  26 25 5  5  5  5  5  5  5  5  5  5  5  5  5  5  5  5  5  5  5  5  5  5  5  5  5  5  5  5  5  5  5  5  5  5  5  5  5  5  5  5  5  5  5  5  5  5  5  5  5  5  5  5  5  5  5  5 
5  5  5  5  5  5  5  5  5  24 5  5  5  5  26 26 25 5  5  5  5  5  26 26 25 25 5  5  5  5  5  25 25 25 25 25 25 25 25 25 5  5  5  5  5  5  5  5  5  5  5  5  5  5  5  5  5  5  5  5  5  5  5  5  5  5  5  5  5  5  5  5  5  5  5  5  25 25 25 25
5  5  5  5  5  5  5  5  5  24 5  5  5  5  5  26 26 25 5  5  5  5  24 26 26 26 5  5  5  5  5  26 24 26 26 26 24 26 26 26 5  5  5  5  5  5  5  5  5  5  5  5  5  5  5  5  5  5  5  5  5  5  5  5  5  5  5  5  5  5  5  5  5  5  5  5  26 24 26 26
5  5  5  5  5  5  25 25 25 25 5  5  5  5  5  5  26 24 25 25 25 25 26 26 26 26 5  5  5  5  5  26 26 26 24 26 5  26 26 24 5  5  5  5  5  5  5  5  5  5  5  5  5  5  5  5  5  5  5  5  5  5  5  5  5  5  5  5  5  5  5  5  5  5  5  5  26 26 26 24
5  5  5  5  5  5  26 26 26 26 5  5  5  5  5  5  5  26 26 26 26 26 26 26 26 26 5  5  5  5  5  26 26 26 26 5  5  5  26 24 25 25 25 25 25 25 25 25 25 25 25 25 25 25 25 25 25 25 25 25 25 25 25 25 25 25 25 25 25 25 25 25 25 25 25 25 26 26 26 26  
