0  0  0  0  0  0  0  0  0  0  0  0  0  0  0  0  0  0  0  0  0  0  0  0  0  0  0  0  0  0  0  0  0  0  0  0  0  0  0  0  0  0  0  0  0  0  0  0  0  0  0  0  0  0  0  0  0  0  0  0  0  0  0  0  0  0  0  0  0  0  0  0  0  0  0  0  0  0  0  0 
0  0  0  0  0  0  0  0  0  0  0  0  0  0  0  0  0  0  0  0  0  0  0  0  0  0  0  0  0  0  0  0  0  0  0  0  0  0  0  0  0  0  0  0  0  0  0  0  0  0  0  0  0  0  0  0  0  0  0  0  0  0  0  0  0  0  0  0  0  0  0  0  0  0  0  0  0  0  0  0 
0  0  0  0  0  0  0  0  0  0  0  0  0  0  0  0  0  0  0  0  0  0  0  0  0  0  0  0  0  0  0  0  0  0  0  0  0  0  0  0  0  0  0  0  0  0  0  0  0  0  0  0  0  0  0  0  0  0  0  0  0  0  0  0  0  0  0  0  0  0  0  0  0  0  0  0  0  0  0  0 
0  0  0  0  0  0  0  0  0  0  0  0  0  0  0  0  0  0  0  0  0  0  0  0  0  0  0  0  0  0  0  12 12 12 12 12 12 12 0  0  0  0  0  0  0  0  0  0  0  0  0  0  0  0  0  0  0  0  0  0  0  0  0  0  0  0  0  0  0  0  0  0  0  0  0  0  0  0  0  0 
0  0  0  0  0  0  0  0  0  12 0  0  0  0  0  0  0  0  0  0  0  0  0  0  0  0  0  0  0  0  0  0  0  0  0  0  0  0  0  0  0  0  0  0  0  0  0  0  0  0  12 12 0  0  0  0  0  0  0  0  0  0  0  0  0  0  0  0  0  0  0  0  0  0  0  0  0  0  0  0 
0  0  0  0  0  0  0  0  12 13 12 0  0  0  0  0  0  0  0  0  0  0  0  0  0  0  0  0  0  0  0  0  0  0  0  0  0  0  0  0  0  0  0  0  0  0  0  0  0  12 13 13 12 0  0  0  0  0  0  0  0  0  0  0  0  0  0  0  0  0  0  0  0  0  0  0  0  0  0  0 
0  0  0  0  0  0  0  12 13 13 13 0  0  0  0  0  0  0  0  0  0  12 12 12 12 12 12 0  0  0  0  0  0  0  0  0  0  0  0  0  0  0  0  0  0  0  0  12 12 13 13 13 13 12 12 0  0  0  0  0  0  0  0  0  12 12 12 12 12 0  0  0  0  0  0  0  0  0  12 12
12 12 0  0  0  0  12 13 13 13 14 0  0  12 12 0  0  0  0  0  12 13 13 13 13 13 13 12 12 0  0  0  0  0  0  0  0  0  0  0  0  0  0  0  0  0  12 13 13 13 13 13 13 13 13 12 12 0  0  0  0  0  0  12 13 13 13 13 13 12 0  0  0  0  0  0  0  12 13 13
13 13 12 12 12 12 13 13 13 0  15 0  0  13 13 12 12 12 12 12 13 13 13 13 13 14 13 13 13 12 12 12 12 12 12 12 12 12 12 0  0  0  0  0  12 12 13 13 13 13 13 13 13 13 13 13 13 12 12 12 12 12 12 13 13 13 13 13 13 13 12 12 12 12 12 12 12 13 13 13
13 13 13 13 13 13 13 13 13 0  16 0  0  13 13 13 13 13 13 13 13 13 13 13 13 16 13 13 13 13 13 13 13 13 13 13 13 13 13 0  0  0  0  0  13 13 13 13 13 13 13 13 13 13 13 13 13 13 13 13 13 13 13 13 13 13 13 13 13 13 13 13 13 13 13 13 13 13 13 13