0  0  0  0  0  0  0  0  0  0  0  0  0  0  0  0  0  0  0  0  0  0  0  0  0  0  0  0  0  0  0  0  0  0  0  0  0  0  0  0  0  0  0  0  0  0  0  0  0  0  0  0  0  0  0  0  0  0  0  0  0  0  0  0  0  0  0  0  0  0  0  0  0  0  0  0  0  0  0  0 
0  0  0  0  0  0  0  0  0  0  0  0  0  0  0  0  0  0  0  0  0  0  0  0  0  0  0  0  0  0  0  0  0  0  0  0  0  0  0  0  0  0  0  0  0  0  0  0  0  0  0  0  0  0  0  0  0  0  0  0  0  0  0  0  0  0  0  0  0  0  0  0  0  0  0  0  0  0  0  0 
0  0  0  0  0  0  0  0  0  0  0  0  0  0  0  0  0  0  0  0  0  0  0  0  0  0  0  0  0  0  0  0  0  0  0  0  0  0  0  0  0  0  0  0  0  0  0  0  0  0  0  0  0  0  0  0  0  0  0  0  0  0  0  0  0  0  0  0  0  0  0  0  0  0  0  0  0  0  0  0 
0  0  0  0  0  0  0  0  0  0  0  0  0  0  0  0  0  0  0  0  0  0  0  0  0  0  0  0  0  0  0  2  2  2  2  2  2  2  0  0  0  0  0  0  0  0  0  0  0  0  0  0  0  0  0  0  0  0  0  0  0  0  0  0  0  0  0  0  0  0  0  0  0  0  0  0  0  0  0  0 
0  0  0  0  0  0  0  0  0  2  0  0  0  0  0  0  0  0  0  0  0  0  0  0  0  0  0  0  0  0  0  0  0  0  0  0  0  0  0  0  0  0  0  0  0  0  0  0  0  0  2  2  0  0  0  0  0  0  0  0  0  0  0  0  0  0  0  0  0  0  0  0  0  0  0  0  0  0  0  0 
0  0  0  0  0  0  0  0  2  3  2  0  0  0  0  0  0  0  0  0  0  0  0  0  0  0  0  0  0  0  0  0  0  0  0  0  0  0  0  0  0  0  0  0  0  0  0  0  0  2  3  3  2  0  0  0  0  0  0  0  0  0  0  0  0  0  0  0  0  0  0  0  0  0  0  0  0  0  0  0 
0  0  0  0  0  0  0  2  3  3  3  0  0  0  0  0  0  0  0  0  0  2  2  2  2  2  2  0  0  0  0  0  0  0  0  0  0  0  0  0  0  0  0  0  0  0  0  2  2  3  3  3  3  2  2  0  0  0  0  0  0  0  0  0  2  2  2  2  2  0  0  0  0  0  0  0  0  0  2  2 
2  2  0  0  0  0  2  3  3  3  4  0  0  2  2  0  0  0  0  0  2  3  3  3  3  3  3  2  2  0  0  0  0  0  0  0  0  0  0  0  0  0  0  0  0  0  2  3  3  3  3  3  3  3  3  2  2  0  0  0  0  0  0  2  3  3  3  3  3  2  0  0  0  0  0  0  0  2  3  3 
3  3  2  2  2  2  3  3  3  0  5  0  0  3  3  2  2  2  2  2  3  3  3  3  3  4  3  3  3  2  2  2  2  2  2  2  2  2  2  0  0  0  0  0  2  2  3  3  3  3  3  3  3  3  3  3  3  2  2  2  2  2  2  3  3  3  3  3  3  3  2  2  2  2  2  2  2  3  3  3 
3  3  3  3  3  3  3  3  3  0  6  0  0  3  3  3  3  3  3  3  3  3  3  3  3  6  3  3  3  3  3  3  3  3  3  3  3  3  3  0  0  0  0  0  3  3  3  3  3  3  3  3  3  3  3  3  3  3  3  3  3  3  3  3  3  3  3  3  3  3  3  3  3  3  3  3  3  3  3  3