1  1  1  1  1  1  1  1  1  1  1  1  1  1  1  1  1  1  1  1  1  1  1  1  1  1  1  1  1  1  1  1  1  1  1  1  1  1  1  1  1  1  1  1  1  1  1  1  1  1  1  1  1  1  1  1  1  1  1  1  1  1  1  1  1  1  1  1  1  1  1  1  1  1  1  1  1  1  1  1 
1  1  1  1  1  1  1  1  1  1  1  1  1  1  1  1  1  1  1  1  1  1  1  1  1  1  1  1  1  1  1  1  1  1  1  1  1  1  1  1  1  1  1  1  1  1  1  1  1  1  1  1  1  1  1  1  1  1  1  1  1  1  1  1  1  1  1  1  1  1  1  1  1  1  1  1  1  1  1  1 
1  1  1  1  1  1  1  1  1  1  1  1  1  1  1  1  1  1  1  1  1  1  1  1  1  1  1  1  1  1  1  1  1  1  1  1  1  1  1  1  1  1  1  1  1  1  1  1  1  1  1  1  1  1  1  1  1  1  1  1  1  1  1  1  1  1  1  1  1  1  1  1  1  1  1  1  1  1  1  1 
1  1  1  1  1  1  1  1  1  1  1  1  1  1  1  1  1  1  1  1  1  1  1  1  1  1  1  1  1  1  1  1  1  1  1  1  1  1  1  1  1  1  1  1  1  1  1  1  1  1  1  1  1  1  1  1  1  1  1  1  1  1  1  1  1  1  1  1  1  1  1  1  1  1  1  1  1  1  1  1 
1  1  1  1  1  1  1  1  1  1  1  1  1  1  1  1  1  1  1  1  1  1  1  1  1  1  1  1  1  1  1  1  1  1  1  1  1  1  1  1  1  1  1  1  1  1  1  1  1  1  20 20 1  1  1  1  1  1  1  1  1  1  1  1  1  1  1  1  1  1  1  1  1  1  1  1  1  1  1  1 
1  1  1  1  1  1  1  1  1  1  1  1  1  1  1  1  1  1  1  1  1  1  1  1  1  1  1  1  1  1  1  1  1  1  1  1  1  1  1  1  1  1  1  1  1  1  1  1  1  20 21 21 20 1  1  1  1  1  1  1  1  1  1  1  1  1  1  1  1  1  1  1  1  1  1  1  1  1  1  1 
1  1  1  1  1  1  1  1  1  1  1  1  1  1  1  1  1  1  1  1  1  20 20 20 20 20 20 1  1  1  1  1  1  1  1  1  1  1  1  1  1  1  1  1  1  1  1  20 20 21 21 21 21 20 20 1  1  1  1  1  1  1  1  1  20 20 20 20 20 1  1  1  1  1  1  1  1  1  20 20 
20 20 20 20 20 20 20 20 20 1  1  20 20 20 20 20 1  1  1  1  20 21 21 21 21 21 21 20 20 1  1  1  1  1  1  1  1  1  1  20 20 20 20 1  1  1  20 21 21 21 21 21 21 21 21 20 20 1  1  1  1  1  1  20 21 21 21 21 21 20 1  1  1  1  1  1  1  20 21 21
21 21 21 21 21 21 21 21 21 1  1  21 21 21 21 21 20 20 20 20 21 21 21 21 21 14 21 21 21 20 20 20 20 20 20 20 20 20 20 21 21 21 21 20 20 20 21 21 21 21 21 21 21 21 21 21 21 20 20 20 20 20 20 21 21 21 21 21 21 21 20 20 20 20 20 20 20 21 21 21
21 21 21 21 21 21 21 21 21 1  1  21 21 21 21 21 21 21 21 21 21 21 21 21 21 16 21 21 21 21 21 21 21 21 21 21 21 21 21 21 21 21 21 21 21 21 21 21 21 21 21 21 21 21 21 21 21 21 21 21 21 21 21 21 21 21 21 21 21 21 21 21 21 21 21 21 21 21 21 21