6  6  6  6  6  6  6  6  6  6  6  6  6  6  6  6  6  6  6  6  6  6  22 6  6  6  6  6  6  6  6  6  6  6  22 6  6  6  6  6  6  6  6  6  6  6  6  6  6  6  6  6  6  6  6  6  6  6  6  6  6  6  6  6  6  6  6  6  6  6  6  6  6  6  6  6  6  6  6  6 
6  6  6  6  6  6  6  6  6  6  6  6  6  6  6  6  6  6  6  6  6  6  22 6  6  6  6  6  6  6  6  6  6  6  22 6  6  6  6  6  6  6  6  6  6  6  6  6  6  6  6  6  6  6  6  6  6  6  6  6  6  6  6  6  6  6  6  6  6  6  6  6  6  6  6  6  6  6  6  6 
6  6  6  6  6  6  6  6  6  6  6  6  6  6  6  6  6  6  6  6  6  6  23 6  6  6  6  6  6  6  6  22 23 23 22 6  6  6  6  6  6  6  6  6  6  6  6  6  6  6  6  6  6  6  6  6  6  6  6  6  6  6  6  6  6  6  6  6  6  6  6  6  6  6  6  6  6  6  6  6 
6  6  6  22 22 22 22 22 23 22 6  6  6  6  6  6  6  6  6  6  6  6  22 22 23 22 22 23 6  6  6  6  6  6  22 6  6  6  6  6  6  6  6  6  6  6  6  6  6  6  6  6  6  6  6  6  6  6  6  6  6  6  6  6  6  6  6  6  6  6  6  6  6  6  6  6  6  6  6  6 
6  6  6  6  6  6  6  6  22 22 23 6  6  6  6  6  6  6  6  6  6  6  22 22 22 23 22 22 22 6  6  6  6  6  22 6  6  6  6  6  6  6  6  6  6  6  6  6  6  6  6  6  6  6  6  6  6  6  6  6  6  6  6  6  6  6  6  6  6  6  6  6  6  6  6  6  6  6  6  6 
6  6  6  6  6  6  6  6  6  22 22 23 6  6  6  6  6  6  6  6  6  6  22 22 22 22 22 22 23 22 6  6  6  6  22 6  6  6  6  6  6  6  6  6  6  6  6  6  6  6  6  6  6  6  6  6  6  6  6  6  6  6  6  6  6  6  6  6  6  6  6  6  6  6  6  6  6  6  6  6 
6  6  6  6  6  6  6  6  6  6  23 22 23 6  6  6  6  6  6  6  6  6  23 22 22 22 6  22 22 22 22 22 23 22 22 6  6  6  6  6  6  6  6  6  6  6  6  6  6  6  6  6  6  6  6  6  6  6  6  6  6  6  6  6  6  6  6  6  6  6  6  6  6  6  6  6  22 22 22 22
22 23 22 22 6  6  6  6  6  6  6  22 22 23 6  6  6  6  6  6  6  6  22 22 22 6  6  6  22 22 22 22 22 22 22 6  6  6  6  6  6  6  6  6  6  6  6  6  6  6  6  6  6  6  6  6  6  6  6  6  6  6  6  6  6  6  6  6  6  6  6  6  6  6  6  6  22 22 22 22
22 22 22 23 6  6  6  6  6  6  6  6  22 22 22 6  6  6  6  6  22 23 22 22 6  6  6  6  6  6  22 22 22 22 23 6  6  6  6  6  6  6  6  6  6  6  6  6  6  6  6  6  6  6  6  6  6  6  6  6  6  6  6  6  6  6  6  6  6  6  6  6  6  6  6  6  22 22 22 22
22 22 22 22 6  6  6  6  6  6  6  6  6  22 22 6  6  6  6  6  22 22 22 22 6  6  6  6  6  6  6  6  22 22 22 22 22 22 22 22 22 22 22 22 22 22 22 22 22 22 22 22 22 22 22 22 22 22 22 22 22 22 22 22 22 22 22 22 22 22 22 22 22 22 22 22 22 22 22 22